1999	Prince	1999	
a_change_is_gonna_come	Sam Cooke	Ain't That Good News	
a_day_in_the_life	The Beatles	Sgt. Pepper's Lonely Hearts Club Band	
a_hard_days_night	The Beatles	A Hard Day's Night	
a_whiter_shade_of_pale	Procol Harum	The Big Chill [Original Soundtrack]	Motown 1983
all_along_the_watchtower	The Jimi Hendrix Experience	Electric Ladyland	
all_apologies	Nirvana	In Utero	
all_i_have_to_do_is_dream	The Everly Brothers	Cadence Classics: Their 20 Greatest Hits	
anarchy_in_the_uk	Sex Pistols	Never Mind the Bollocks Here's the Sex Pistols	
back_in_black	AC/DC	Back in Black	
be_my_baby	The Ronettes	Phil Spector: Back to Mono (1958-1969)	ABKCO 1991
be-bop-a-lula	Gene Vincent	All Time Greatest Hits of Rock 'n' Roll	CURB 1990
billie_jean	Michael Jackson	Thriller	
bitter_sweet_symphony	The Verve	Urban Hymns	
bizarre_love_triangle	New Order	Substance	
blitzkrieg_bop	The Ramones	Ramones	
blowin_in_the_wind	Bob Dylan	The Freewheelin' Bob Dylan	
blue_suede_shoes_perkins	Carl Perkins	Original Sun Greatest Hits	
blueberry_hill	Fats Domino	They Call Me the Fat Man: The Legendary Imperial Recordings	
bo_diddley	Bo Diddley	His Best	Chess 1997
bohemian_rhapsody	Queen	A Night at the Opera	
born_to_be_wild	Steppenwolf	16 Greatest Hits	MCA 1973
born_to_run	Bruce Springsteen	Born to Run	
both_sides_now	Joni Mitchell	Clouds	
bridge_over_troubled_water	Simon and Garfunkel	Bridge Over Troubled Water	
bring_the_noise	Public Enemy	It Takes a Nation of Millions to Hold Us Back	
brown_eyed_girl	Van Morrison	Bang Masters	Epic 1991
california_dreamin	The Mamas & the Papas	Greatest Hits	MCA 1998
california_girls	The Beach Boys	Endless Summer	Capitol 1974
california_love	Dr. Dre and 2Pac	Greatest Hits	
cathys_clown	The Everly Brothers	The Very Best of the Everly Brothers	Warner Bros. 1964
changes	David Bowie	Hunky Dory	
come_as_you_are	Nirvana	Nevermind	
crazy	Patsy Cline	Gold	MCA Nashville 2005
crying	Roy Orbison	For the Lonely: 18 Greatest Hits	Rhino 1988
da_doo_ron_ron	The Crystals	Phil Spector: Back to Mono (1958-1969)	ABKCO 1991
dancing_in_the_street	Martha and the Vandellas	The Ultimate Collection	Motown 1998
dancing_queen	Abba	Gold: Greatest Hits	Polydor 1993
dont_worry_baby	The Beach Boys	Endless Summer	Capitol 1974
dream_on	Aerosmith	Aerosmith	
earth_angel	The Penguins	Billboard Top Rock 'n' Roll Hits: 1955	
eight_miles_high	The Byrds	Fifth Dimension	
eleanor_rigby	The Beatles	Revolver	
enter_sandman	Metallica	Black Album	
every_breath_you_take	The Police	Synchronicity	
everyday_people	Sly and the Family Stone	Anthology	Epic 1981
fake_plastic_trees	Radiohead	The Bends	
family_affair	Sly and the Family Stone	Anthology	Epic 1981
fast_car	Tracy Chapman	Tracy Chapman	
folsom_prison_blues	Johnny Cash	Best of the Sun Years, 1955-1961	Music Club Records 1994
for_what_its_worth	Buffalo Springfield	Buffalo Springfield	
fortunate_son	Creedence Clearwater Revival	Chronicle, Vol. 1	Ace 1976
foxey_lady	The Jimi Hendrix Experience	Are You Experienced?	
free_fallin	Tom Petty	Full Moon Fever	
georgia_on_my_miind	Ray Charles	The Very Best of Ray Charles	Rhino 2000
gimme_shelter	The Rolling Stones	Let It Bleed	
go_your_own_way	Fleetwood Mac	Rumours	Reprise 1977
god_only_knows	The Beach Boys	Pet Sounds	
god_save_the_queen	The Sex Pistols	Never Mind the Bollocks Here's the Sex Pistols	
good_golly_miss_molly	Little Richard	18 Greatest Hits	Rhino 1985
good_vibrations	The Beach Boys	Endless Summer	Capitol 1974
great_balls_of_fire	Jerry Lee Lewis	18 Original Sun Greatest Hits	Rhino 1984
hallelujah	Jeff Buckley	Grace	
heartbreak_hotel	Elvis Presley	Elv1s: 30 #1 Hits	RCA 2002
help	The Beatles	Help!	
heroes	David Bowie	"Heroes"	
hey_jude	The Beatles	Past Masters, Vol. 2	
honky_tonk_women	The Rolling Stones	Through the Past, Darkly (Big Hits Vol. 2)	
hot_stuff	Donna Summer	Casablanca Greatest Hits	
hotel_california	The Eagles	Hotel California	
hound_dog	Elvis Presley	Elv1s: 30 #1 Hits	RCA 2002
house_of_the_rising_sun	The Animals	The Best of the Animals	ABKCO 1966
i_believe_i_can_fly	R. Kelly	R.	
i_cant_make_you_love_me	Bonnie Raitt	Luck of the Draw	
i_cant_stop_loving_you	Ray Charles	The Very Best of Ray Charles	Rhino 2000
i_fought_the_law	The Bobby Fuller Four	60s Rock: The Beat Goes On	Rhino 1997
i_got_you	James Brown	Star Time	Polydor 1991
i_heard_it_through_the_grapevine	Marvin Gaye	20th Century Masters - The Millennium Colelction: The Best Of Marvin Gaye, Vol. 1	Uptown/Universal 1999
i_only_have_eyes_for_you	The Flamingos	The Best of the Flamingos	Rhino 1990
i_saw_her_standing_there	The Beatles	Please Please Me	
i_still_havent_found_what_im_looking_for	U2	The Joshua Tree	
i_walk_the_line	Johnny Cash	Best of the Sun Years, 1955-1961	Music Club Records 1994
i_wanna_be_sedated	The Ramones	Road to Ruin	
i_want_to_hold_your_hand	The Beatles	Past Masters, Vol. 1	
i_want_you_back	The Jackson 5	The Ultimate Collection	Motown 1995
im_so_lonesome_i_could_cry	Hank Williams	24 Greatest Hits	Mercury 1976
im_waiting_for_the_man	The Velvet Underground	The Velvet Underground & Nico	
imagine	John Lennon	Imagine	
in_bloom	Nirvana	Nevermind	
in_my_life	The Beatles	Rubber Soul	
in_the_midnight_hour	Wilson Pickett	The Very Best of Wilson Pickett	Rhino 1993
in_the_still_of_the_nite	The Five Satins	In the Still of the Night [Relic]	
its_a_mans_mans_mans_world	James Brown	Star Time	Polydor 1991
ive_been_loving_you_too_long	Otis Redding	The Very Best of Otis Redding, Vol. 1	Rhino 1992
jailhouse_rock	Elvis Presley	Elv1s: 30 #1 Hits	RCA 2002
johnny_b_goode	Chuck Berry	Chuck Berry is on Top	
jumpin_jack_flash	The Rolling Stones	Through the Past, Darkly (Big Hits Vol. 2)	
kashmir	Led Zeppelin	Physical Graffiti	
layla	Derek and the Dominos	Layla & Other Assorted Love Songs	
let_it_be	The Beatles	Let It Be	
lets_get_it_on	Marvin Gaye	Let's Get It On	
lets_stay_together	Al Green	Greatest Hits	The Right Stuff 1975
light_my_fire	The Doors	The Doors	
like_a_rolling_stone	Bob Dylan	Highway 61 Revisited	
little_red_corvette	Prince	1999	
living_for_the_city	Stevie Wonder	Innervisions	
london_calling	The Clash	London Calling	
long_tall_sally	Little Richard	18 Greatest Hits	Rhino 1985
lose_yourself	Eminem		
loser	Beck	Mellow Gold	
losing_my_religion	R.E.M.	Out of Time	
louie_louie	The Kingsmen	Billboard Top Rock 'n' Roll Hits: 1963	Rhino 1993
love_and_happiness	Al Green	I'm Still in Love With You	The Right Stuff 1975
love_will_tear_us_apart	Joy Division	Substance	
lust_for_life	Iggy Pop	Nude & Rude: The Best of Iggy Pop	Virgin 1996
maggie_may	Rod Stewart	Every Picture Tells a Story	
maybellene	Chuck Berry	The Great Twenty Eight	Chess 1982
me_and_bobby_mcgee	Janis Joplin	Pearl	
mr_tambourine_man_byrds	The Byrds	Mr. Tambourine Man	
mr_tambourine_man_dylan	Bob Dylan	Bringing It All Back Home	
my_generation	The Who	The Who Sings My Generation	
my_girl	The Temptations	The Ultimate Collection	Motown 1997
mystery_train	Elvis Presley	The King of Rock 'n' Roll: The Complete 50's Masters	RCA 1992
no_woman_no_cry	Bob Marley & The Wailers	Natty Dread	
norwegian_wood	The Beatles	Rubber Soul	
not_fade_away	Buddy Holly and the Crickets	Greatest Hits	MCA 1996
nothing_compares_2_u	Sinead O'Connor	I Do Not Want What I Haven't Got	
nuthin_but_a_g_thang	Dr. Dre	The Chronic	
one	U2	Achtung Baby	
paint_it_black	The Rolling Stones	Through the Past, Darkly (Big Hits Vol. 2)	
papa_was_a_rollin_stone	The Temptations	The Ultimate Collection	Motown 1997
papas_got_a_brand_new_bag	James Brown	Star Time	Polydor 1991
paranoid_android	Radiohead	OK Computer	
people_get_ready	The Impressions	Greatest Hits	MCA 1982
please_please_please	James Brown	Star Time	Polydor 1991
proud_mary	Creedence Clearwater Revival	Chronicle, Vol. 1	Ace 1976
purple_haze	The Jimi Hendrix Experience	Are You Experienced?	
purple_rain	Prince	Purple Rain	
rave_on	Buddy Holly and the Crickets	Greatest Hits	MCA 1996
redemption_song	Bob Marley & The Wailers	Legend	
respect	Aretha Franklin	30 Greatest Hits	Atlantic 1985
ring_of_fire	Johnny Cash	The Legend	Sony 2010
river_deep_mountain_high	Ike & Tina Turner	Proud Mary: The Best of Ike and Tina Turner	
rock_and_roll_music	Chuck Berry	The Great Twenty Eight	Chess 1982
rock_around_the_clock	Bill Haley and His Comets	20th Century Masters - The Millennium Collection: The Best of Bill Haley & His Comets	MCA 1999
rock_lobster	The B-52's	The B-52's	
rockin_in_the_free_world	Neil Young	Freedom	
roll_over_beethoven	Chuck Berry	Chuck Berry is on Top	
sabotage	The Beastie Boys	Ill Communication	
satisfaction	The Rolling Stones	Out of Our Heads	ABKCO [USA]
september_gurls	Big Star	#1 Record/Radio City	
shake_rattle_and_roll	Big Joe Turner	The Very Best of Big Joe Turner	Rhino 2009
she_loves_you	The Beatles	Past Masters, Vol. 1	
should_i_stay_or_should_i_go	The Clash	Combat Rock	
shout	The Isley Brothers	The Ultimate Isley Brothers	Sony 2000
smells_like_teen_spirit	Nirvana	Nevermind	
stairway_to_heaven	Led Zeppelin	Led Zeppelin IV	
stand_by_me	Ben E. King	Billboard Top Rock 'n' Roll Hits: 1961	Rhino 1993
strawberry_fields_forever	The Beatles	Magical Mystery Tour	
summer_babe	Pavement	Slanted & Enchanted	
summertime_blues	Eddie Cochran	The Best of Eddie Cochran	EMI 1985
sunshine_of_your_love	Cream	Disraeli Gears	
superstition	Stevie Wonder	Talking Book	
suspicious_minds	Elvis Presley	Elv1s: 30 #1 Hits	RCA 2002
sweet_child_o_mine	Guns N' Roses	Appetite for Destruction	
sympathy_for_the_devil	The Rolling Stones	Beggars Banquet	
take_me_to_the_river	Al Green	More Greatest Hits	Capitol 1998
tangled_up_in_blue	Bob Dylan	Blood on the Tracks	
tears_in_heaven	Eric Clapton	Rush [Soundtrack]	
thatll_be_the_day	Buddy Holly	Greatest Hits	MCA 1996
thats_all_right	Elvis Presley	The King of Rock 'n' Roll: The Complete 50's Masters	RCA 1992
the_boxer	Simon and Garfunkel	Bridge Over Troubled Water	
the_dock_of_the_bay	Otis Redding	The Very Best of Otis Redding, Vol. 1	Rhino 1992
the_message	Grandmaster Flash & the Furious Five	The Message	
the_sounds_of_silence	Simon and Garfunkel	Sounds of Silence	Columbia 1966
the_times_they_are_a-changin	Bob Dylan	The Times They Are A-Changin'	
the_tracks_of_my_tears	The Miracles	The Ultimate Collection	Motown 1998
the_weight	The Band	Music From Big Pink	
thunder_road	Bruce Springsteen	Born to Run	
tutti_frutti	Little Richard	18 Greatest Hits	Rhino 1985
up_on_the_roof	The Drifters	The Very Best of the Drifters	Rhino 1993
voodoo_child	Jimi Hendrix	Electric Ladyland	
walk_on_by	Dionne Warwick	The Definitive Collection	Arista 1999
waterloo_sunset	The Kinks	Remastered 1964 - 1967	Essential 1996
whatd_i_say	Ray Charles	The Best of Ray Charles: The Atlantic Years	
whats_going_on	Marvin Gaye	What's Going On	
when_a_man_loves_a_woman	Percy Sledge	It Tears Me Up: The Best of Percy Sledge	Rhino 1992
when_doves_cry	Prince and the Revolution	Purple Rain	
while_my_guitar_gently_weeps	The Beatles	The White Album	
who_do_you_love	Bo Diddley	His Best	Chess 1997
whole_lotta_love	Led Zeppelin	Led Zeppelin II	
whole_lotta_shakin_goin_on	Jerry Lee Lewis	18 Original Sun Greatest Hits	Rhino 1984
will_you_love_me_tomorrow	The Shirelles	The Very Best of the Shirelles	Rhino 1975
with_or_without_you	U2	The Joshua Tree	
wont_get_fooled_again	The Who	Who's Next	
yesterday	The Beatles	Help!	
you_cant_always_get_what_you_want	The Rolling Stones	Let It Bleed	
you_really_got_me	The Kinks	Remastered 1964 - 1967	Essential 1996
you_send_me	Sam Cooke	The Man and His Music	RCA 1986
your_song	Elton John	Elton John	
youve_lost_that_lovin_feelin	The Righteous Brothers	Anthology: 1962 - 1974	Rhino 1989
	